XXXXXXXX
XR.R..MX
XR.....X
X....R.X
X..R...X
XIR...BX
XXXXXXXX