XXXXXXXX
XRI....X
X.RRR..X
X......X
X.R.RRRX
X.....BX
XXXXXXXX