XXXXXXXX
XVM.MR.X
X...R..X
X..I.V.X
X.R....X
XP..R.BX
XXXXXXXX