XXXXXXXX
X......X
XR.RVIRX
X...RRRX
X...R..X
XVR...BX
XXXXXXXX