XXXXXXXX
X.I....X
X......X
X....E.X
X.P....X
X.....BX
XXXXXXXX